00000000010010000000
00000000001100011000
00000001000000000000
00000000000000000000
01000000000000000000
00000000000001100000
00000000000000000000
00000000000000000000
00000001011000000000
00000001000000000000
00110000000000000000
00000000010000100000
01000000000000000000
00000000000011000000
00000000000011000000